111111
101011
101001
101101
100001
111111