11111111111111111111111111111
12222222222222122222222222221
12111121111112121111112111121
13111121111112121111112111131
12111121111112121111112111121
12222222222222222222222222221
12111121211111111111212111121
12111121222222122222212111121
12222221111110101111112222221
11111121111110101111112111111
00000121111110101111112100000
11111121000000000000012111111
00000020011011411011002000000
11111121111010001011112111111
00000021111010001011112000000
11111120011011111011002111111
00000121000000000000012100000
11111121111110101111112111111
12222221111110101111112222221
12112121111110101111112121121
12112121222222122222212121121
12112121211111111111212121121
12112122222222222222222121121
12222111111112121111111122221
11112222222222122222222221111
11112111212112221121211121111
12222222212122122121222222221
12111121212221112221212111121
13122221212122122121212222131
12121111212112221121211112121
12222222222222122222222222221
11111111111111111111111111111