111111
101101
101101
101101
100001
111111