1111111111
1110000001
1110111111
1000000001
1011110101
1010000101
1010111101
1000000001
1111111111